A.	1) Atmanêpadum. 2) Arg'uni reditus ex Indri coelo. (*)
AM.	Amara- Kôscha.
BH.	Bhagavad-Gita.
BHATT.	Bhatti – Kâvya.
BHAR.	Bhartriharis (ed. Bohlen).
BR.	Brahmani lamentatio. (**)
DEV.	Dêvîmâhâtmya (ed. Poley. Berol. apud Ferd. Dümmler).
DR.	Draupadiae raptus (in libro meo «Diluvium»).
GHAT.	Ghatakarpara (ed. Dursch. Berol. apud F. Dümmler).
GITA-G.	Gîta-Govinda ed. Lassen.
H.	Hidimbi caedes. (**)
HIT.	Hitopadesa (ed. Bonn.)
IN.	Indralôkågamanam. (**)
K.	Kâs'inâthus, grammaticus indicus, cujus radicum collectionem edidit Wilkinsius (The radicals of the Sanscrita Language, London 1815). (****)
Lass.	Lassenii Anthologia Sanscritica.
M.	Matsyôpâkhyâna, i.e. episodium de diluvio.
MAH.	Mahâ- Bhârata ed. Calc.
MAN.	Manu-Sâstra.
MR.	Mric c'akatî.
N.	Nalus (Berol. apud Nicolai).
P.	1) Parasmaipadum. 2) Påtaliputra (ed. H. Brockhaus. Lipsiae 1835.)
PAN.	Pâninis.
RAGH.	Raghu-Vansa (ed. Stenzler).
RAM.	Râmâyana ed. Seramp.
R. Schl.	Schlegelii editio Râmâyanae.
RIGV.	Rigveda-Sanhitae liber primus (sanscrite et latine edidit Fr. Rosen, cujus versionem locis laudatis apposui).
RIGV. V.	Rigvêdae liber quintus, cujus exempla e Vas'is thi hymnis sumta affert Westergardius in libro suo Radices
RIGV. Sp.	Fr. Rosenii Rigva - Specimen.
SA.	episodium de Sâvitria. (**)
SAK.	Sakuntala ed. Chézy.
SU.	Sundus et Upasundus. (***)
UP.	Upakôsa (in libro «Pâtaliputra» ed. Brockhaus).
UR.	Urvasia (ed. Lenz, Berol., apud Ferd. Dümmler).
V.	Vôpadêvus grammaticus cujus radicum corpus, Kavikalpadruma inscriptum, edidit W. Carey in grammaticâ suâ. Westerg. est Westergardii liber Radices sanscritae inscriptus.
